7
4
#######
# # # #
# # #
#######
1 1 1 3
1 3 1 1
1 3 2 1
1 1 1 5